format=SD

All Skills=allskills
Alchemy=alchemy
Anatomy=anatomy
Animal Lore=animallore
Animal Taming=taming
Archery=archery
Arms Lore=armslore
Begging=begging
Blacksmithy=blacksmithing
Bowcraft/Fletching=bowcraft
Camping=camping
Carpentry=carpentry
Cartography=cartography
Cooking=cooking
Detecting Hidden=detectinghidden
Enticement=enticement
Evaluating Intelligence=evaluatingintel
Fencing=fencing
Fishing=fishing
Forensic Evaluation=forensics
Healing=healing
Herding=herding
Hiding=hiding
Inscription=inscription
Item Identification=itemid
Lockpicking=lockpicking
Lumberjacking=lumberjacking
Mace Fighting=macefighting
Magery=magery
Meditation=meditation
Mining=mining
Musicianship=musicianship
Parrying=parrying
Peacemaking=peacemaking
Poisoning=poisoning
Provocation=provocation
Remove Trap=removetraps
Resisting Spells=magicresistance
Snooping=snooping
Spirit Speak=spiritspeak
Stealing=stealing
Stealth=stealth
Swordsmanship=swordsmanship
Tactics=tactics
Tailoring=tailoring
Taste Identification=tasteid
Tinkering=tinkering
Tracking=tracking
Veterinary=veterinary
Wrestling=wrestling